FRA	= "countries/France.txt"
COS  = "countries/Corsica.txt"
BRT  = "countries/Brittany.txt"
PRO  = "countries/Provence.txt"
GAS  = "countries/Gascogne.txt"
NAV  = "countries/Navarre.txt"
ALG  = "countries/Algeria.txt"
GBR  = "countries/Great_Britain.txt"
SCO  = "countries/Scotland.txt"
IRE  = "countries/Ireland.txt"
WEI  = "countries/Welsh.txt"
KVO  = "countries/Cornwall.txt"
NOS  = "countries/Northumbria.txt"
ENG  = "countries/England.txt"
AUS  = "countries/Austria.txt"
HUN  = "countries/Hungary.txt"
SLO  = "countries/Slovakia.txt"
CRO  = "countries/Croatia.txt"
SLV  = "countries/Slovenia.txt"
TRL  = "countries/Transylvania.txt"
CLA  = "countries/Galicia-Volinia.txt"
CZE  = "countries/Czekh.txt"
BNT  = "countries/Banat.txt"
VEN  = "countries/Venice.txt"
RUS  = "countries/Russia.txt"
POL  = "countries/Poland.txt"
UKR  = "countries/Ukraine.txt"
BLG  = "countries/Belarus.txt"
EST  = "countries/Esthonia.txt"
LAT  = "countries/Latvia.txt"
LIT  = "countries/Lithuania.txt"
ASK  = "countries/Alaska.txt"
KAZ  = "countries/Kazan.txt"
CRI  = "countries/Crimea.txt"
ASL  = "countries/Astrakhan.txt"
DON  = "countries/Don_river_Cossack.txt"
GLS  = "countries/The_North_Caucasus_Cossack.txt"
GEO  = "countries/Georgia.txt"
ASB  = "countries/Azerbaijan.txt"
HAZ  = "countries/Kazakhstan.txt"
TJK  = "countries/Tajikistan.txt"
UZB  = "countries/Uzbekistan.txt"
TKM  = "countries/Turkmen.txt"
GRG  = "countries/Kyrgyzstan.txt"
SIB  = "countries/Siberia.txt"
GER  = "countries/Germany.txt"
PRU  = "countries/Prussia.txt"
BAV  = "countries/Bavaria.txt"
HOL  = "countries/Schleswig-Holstein.txt"
BAD  = "countries/Bardon.txt"
WTB  = "countries/Wurttemberg.txt"
RHN  = "countries/Rhineland.txt"
HAN  = "countries/Hanoverian.txt"
MEL  = "countries/Mecklenburg.txt"
SAX  = "countries/Saxon.txt"
SLI  = "countries/Silesia.txt"
TLG  = "countries/Th√ºringen.txt"
HES  = "countries/Heessen.txt"
AES  = "countries/Alsace.txt"
BOR  = "countries/Brandebourg.txt"
LKE  = "countries/Leakhite.txt"
ITA  = "countries/Italy.txt"
LBD  = "countries/Lombardy.txt"
SAV  = "countries/Savoy.txt"
STD  = "countries/Sardinia.txt"
PIE  = "countries/Piedmont.txt"
GEN  = "countries/Genoa.txt"
FER  = "countries/Ferrara.txt"
MDN  = "countries/Modena.txt"
FOL  = "countries/Florence.txt"
PAP  = "countries/Pope.txt"
NAP  = "countries/Neaples.txt"
SIC  = "countries/Sicily.txt"
MLT  = "countries/Malta.txt"
SPC	= "countries/Spain_communist.txt"
CAT  = "countries/Catalonian.txt"
VAL  = "countries/Valentia.txt"
ARA  = "countries/Aragon.txt"
ADU  = "countries/Andalusian.txt"
GAC  = "countries/Galicia.txt"
ASU  = "countries/Asturias.txt"
LEO  = "countries/Lyon.txt"
TRO  = "countries/Toledo.txt"
CAS  = "countries/Castilla.txt"
BYZ	= "countries/Byzantium.txt"
SRP  = "countries/Cyprus.txt"
POR  = "countries/Portuguesa.txt"
ALB  = "countries/Albania.txt"
KSO  = "countries/Kosovo.txt"
BUR  = "countries/Bulgaria.txt"
SBU	= "countries/Serbia-BosniaUnion.txt"
SER  = "countries/Serbia.txt"
BOS  = "countries/Bosnia.txt"
HSG  = "countries/Herzegovina.txt"
ROM  = "countries/Romania.txt"
MOR  = "countries/Moldavia.txt"
WAL  = "countries/Wallachia.txt"
SWI  = "countries/Switzerland.txt"
DAN  = "countries/Denmark.txt"
ICE  = "countries/Iceland.txt"
NOR  = "countries/Norway.txt"
SWE  = "countries/Sweden.txt"
SAR  = "countries/Sami.txt"
FIN  = "countries/Finland.txt"
KAR  = "countries/Krakow.txt"
BEL  = "countries/Belgium.txt"
FLD  = "countries/Flanders.txt"  
WLO  = "countries/Wallonia.txt"
LUX  = "countries/Luxembourg.txt"
NER  = "countries/Nederland.txt"
QNG  = "countries/The_Qing_Empire.txt"
JAP  = "countries/Japan.txt"
JPR  = "countries/Ryukyu.txt"
JPX  = "countries/Shimadzu.txt"
JPN  = "countries/Nabeshima.txt"
JPM  = "countries/Mouri.txt"
JPY  = "countries/Yamauchi.txt"
JPU  = "countries/Uesugi.txt"
JPT  = "countries/Tokugawa.txt"
JPD  = "countries/Date.txt"
JPE  = "countries/Toudou.txt"
JPO  = "countries/Ookubo.txt"
JPS  = "countries/Matsumae.txt"
KOR  = "countries/Korea.txt"
KOS  = "countries/Gyeonggi.txt"
KOP  = "countries/Gangbug.txt"
KOC  = "countries/Samhan.txt"
VET  = "countries/Vietnam.txt"
VTT  = "countries/Tokin.txt"
VTA  = "countries/Annam.txt"
VTZ  = "countries/Champa.txt"
MNG  = "countries/Mongolia.txt"
MNT  = "countries/Tannu_Uriankhai..txt"
MNE  = "countries/East_Mongolia.txt"
MNW  = "countries/West_Mongolia.txt"
TIB  = "countries/Tibet.txt"
TBQ  = "countries/Qinghai.txt"
TBK  = "countries/Xikang.txt"
TBL  = "countries/Shigatse.txt"
TBD  = "countries/Ladakh.txt"
TBW  = "countries/Outer_Himalayan.txt"
CHX  = "countries/Xinjiang.txt"
CXB  = "countries/Dihua.txt"
CXY  = "countries/Ili.txt"
CXK  = "countries/Kashgar.txt"
CHY  = "countries/Xinan.txt"
CYY  = "countries/Yunnan.txt"
CYG  = "countries/Guizhou.txt"
CHG  = "countries/Liangguang.txt"
CGE  = "countries/Guangdong.txt"
CGW  = "countries/Guangxi.txt"
CHS  = "countries/Xibei.txt"
CSS  = "countries/Shannxi.txt"
CSG  = "countries/Gansu.txt"
CSJ  = "countries/Shanxi.txt"
CSY  = "countries/Guisui.txt"
CHB  = "countries/Huabei.txt"
CBS  = "countries/Shandong.txt"
CBZ  = "countries/Zhili.txt"
CBH  = "countries/Henan.txt"
CHW  = "countries/Dongnan.txt"
CWA  = "countries/Anhui.txt"
CWJ  = "countries/Jiangsu.txt"
CWZ  = "countries/Zhejiang.txt"
CWF  = "countries/Fujian.txt"
CHM  = "countries/Dongbei.txt"
CML  = "countries/Fengtian.txt"
CMJ  = "countries/Jilin.txt"
CMH  = "countries/Heilongjiang.txt"
CMC  = "countries/Chahaer.txt"
CHC  = "countries/Sichuan.txt"
CCC  = "countries/Chongqing.txt"
CCN  = "countries/Chuanbei.txt"
CCW  = "countries/Chuanxi.txt"
CCE  = "countries/Chuandong.txt"
CHN  = "countries/Huanan.txt"
CNB  = "countries/Hubei.txt"
CNS  = "countries/Hunan.txt"
CNJ  = "countries/Jiangxi.txt"
AFK  = "countries/Afghanistan.txt"
IND  = "countries/India.txt"
HID  = "countries/Hindustan.txt"
BAN  = "countries/Bengal.txt"
ASM  = "countries/Assum.txt"
LJS  = "countries/Rajasthan.txt"
GOC  = "countries/Gujarat.txt"
MRP  = "countries/Malava.txt"
ORS  = "countries/Ollisa.txt"
ADR  = "countries/Andhra.txt"
MRD  = "countries/Marathi.txt"
MSR  = "countries/Mysore.txt"
TMR  = "countries/Tamil.txt"
KRR  = "countries/Kerala.txt"
PAK = "countries/Pakistan.txt"
PUN = "countries/Punjab.txt"
BAL = "countries/Baluchistan.txt"
SIN = "countries/Sindh.txt"
HYD = "countries/Hyderabad.txt"
BIH = "countries/Bihar.txt"
IRA  = "countries/Iran.txt"
ASS  = "countries/Assyria.txt"
AME  = "countries/Armenia.txt"
TUR  = "countries/Turkey.txt"
TRA  = "countries/Trabison.txt"
IRQ  = "countries/Iraq.txt"
LEV  = "countries/Levant.txt"
SYR  = "countries/Syria.txt"
LBN  = "countries/Lebanon.txt"
PLS  = "countries/Palestine.txt"
JOR  = "countries/Jordan.txt"
ARB  = "countries/Arab.txt"
YEM  = "countries/Yemen.txt"
AMM  = "countries/Oman.txt"
NNG  = "countries/Najd.txt"
HNG  = "countries/Hejaz.txt"
MYA  = "countries/Myanmar.txt"
SHN  = "countries/lana.txt"
SYY  = "countries/Siam.txt"
MWA  = "countries/Bago.txt"
CAM  = "countries/Cambodia.txt"
LAO  = "countries/Laos.txt"
INO  = "countries/Indonesia.txt"
LNF  = "countries/Lanfang.txt"
WEN  = "countries/Brunei.txt"
PHL  = "countries/Philippine.txt"
MAL  = "countries/Malaya.txt"
MOC  = "countries/Morocco.txt"
EGY  = "countries/Egypt.txt"
SUD  = "countries/Sudan.txt"
SSU  = "countries/South_Sudan.txt"
LBY  = "countries/Libya.txt"
PGN  = "countries/Portuguese-Guinea.txt"
WAF  = "countries/West_Africa.txt"
EWA  = "countries/British-West_Africa.txt"
ETH  = "countries/Ethiopia.txt"
ERI  = "countries/Eritrea.txt"
CGN  = "countries/Congo.txt"
MAF  = "countries/Central_African.txt"
AGR  = "countries/Angola.txt"
SWA  = "countries/Swahili.txt"
BUL  = "countries/Boer.txt"
ESA  = "countries/British-South_Africa.txt"
EMA  = "countries/British-Central_Africa.txt"
GFA  = "countries/German-African.txt"
FCA  = "countries/France-African.txt"
ISL  = "countries/Israel.txt"
MGS  = "countries/Madagascar.txt"
USA  = "countries/United_States_of_America.txt"
NFR  = "countries/New_France.txt"
CAL  = "countries/California.txt"
TEX  = "countries/Texas.txt"
NEN  = "countries/New_England.txt"
CSA  = "countries/Confederate_States_of_America.txt"
FSA  = "countries/Free_States_of_America .txt"
UWA  = "countries/United_Corps_of_America.txt"
CAN  = "countries/Canada.txt"
KBK  = "countries/Quebec.txt"
MEX  = "countries/Mexico.txt"
YCK  = "countries/Yucatan.txt"
UCA  = "countries/Central_American_Confederacy.txt"
SAW  = "countries/Salvador.txt"
KDI  = "countries/Guatemala.txt"
BLZ  = "countries/Belize.txt"
GOS  = "countries/Costarica.txt"
PNM  = "countries/Panama.txt"
HOD  = "countries/Honduras.txt"
NCA  = "countries/Nigaragua.txt"
CLO  = "countries/Columbia.txt"
VEA  = "countries/Ventrilla.txt"
ECU  = "countries/Ecuador.txt"
BRZ  = "countries/Brazil.txt"
PEU  = "countries/Peru.txt"
BVO  = "countries/Bolivia.txt"
CHL  = "countries/Chile.txt"
ARG  = "countries/Argentina.txt"
PLG  = "countries/Paraguay.txt"
ULG  = "countries/Uruguay.txt"
GUP  = "countries/Spain-Cuba.txt"
HAI  = "countries/Haiti.txt"
DOM  = "countries/Dominican.txt"
WIE  = "countries/West_India.txt"
GUI  = "countries/Guyana.txt"
AUT  = "countries/Australia.txt"
NZL  = "countries/New_Zealand.txt"
PLI  = "countries/Polynesia.txt"
HAW  = "countries/Hawaii.txt"



